1010101000111001111000111100110111000000010100100101100010000010
1101011011111111010110011111110000010001001101101000101011001100
1111100100011111011010101111101100111011100100011011000010000101
0001111001010100010011010011011011110110100010001101000101111110
1010001000010010011110110110001010110000101110111100001011100001
1111101101111100001110101110011100000100100111101111110010010011
1111101000000101010001100011010001101110100101000111000101101010
1110101010011010011110000001111110001001111110100000001000111000
0110111000110110111001100011101110100101010010100010101000100010
1111010000001101111111010000001100101010001100101100010011101000
0011100110001110101010000111100111011101101000110110001000000110
1110110001010100111100111011111111101111101111111011000101001110
1101110100111000011010111011111000001001011000101011101100000101
1001111110111110110101011101010111011010100110101100011111100100
0111101101111010010100111001110000111100110110101000011101001000
0100111101000111101110000101111111111001100101101011110100010001
1100110001011110011100110010111000000110111100010101011101110011
1101010110010011100001110101101110001010011110110101110011100001
0111010010100110110100011000111101100100110011011010001010111011
0111000000011110101010010110101000111100110001001000101001000000
0011110010101001101001010110111000010000110100011011111011001011
1110000000100111110111011011011010111011101011110010100101011111
0010010011101111000000110010000100001101000000001110010111101100
0001001010011100111110111101000111111000000110011010111100100101
1111010000110110110110011000000000100110010101000011000111010000
1011110100101011011010111001110100101100111110111001011111011000
0111101100011011100101001100000001100100000100010100100101101111
1110011110101101111001101101000010101101000011010101010110010010
0111111011001000010100000100001110001101011011100001100100000000
0000111010101100110001101010110101001000001011010010011011011010
0001100110110000011001010000110001001011000001000100000010001010
1100000001111001111110101101111111000011000000011011010010010110
0110000100011100100010000000001110010000101100111011010010110000
0101011101011111011110000001110001001000110010011000010101010101
0110000111010001100010110100111101001011011101110010100101111110
0011110010110010010001010101011001100111100111011111011100101100
0101001110001111000110100010010111100100000001000011010001110001
0011011010110110101011001110101000100001100010110010100101100001
0111110111100101011001000000001101000000110011001110100000001110
0100001010001011000101001101000001111011011011011011001000000010
1011101101000111011101001011101111101101000101001101101101010010
1011010110010010100101110111001011010011001100110011011110110101
1100010000001111110101110001010111100101100000011100010101011011
0010101101101111100110100010101000111010010010110011001110001000
1100101010011111000011000100110101000100110110010111110010010000
1100110100011101011111100100001101000100100011110101010010000100
1010110100010000010000110111001011001010111111011110010001001100
1110000001101011010011101000001010000010100001110001110110110010
1100100110011001000101101001000001000111000100010100110011010000
1011001101111101111100101001010101011000011100110010101111010100
1011110111011110000000100010101111000001001000111010111001101110
0010101000101101001110100000101110111111001010110000011101011011
1001101001000010110000101110101100000010011000010000100011011100
1011100110000100111110010011001111000110010001110010010101001000
0111001100010011000011101001011001101001000101011010011010001010
0010010110011001010110111000111100110101011001100011011000111011
1000011111101010110111000010101001100100111101010011100011001000
1101111110101010010101100000111000000010111110110111010010100000
0010000010000101000010011111010110110110101110111010101111000101
0111001011100100110110000011011111110011101011110110000100111111
1110001001110110000010011101010110000010011001011000011010100001
1100000000100011001011110110111101010000101001101010000111011101
0011011001101100001101010100000011010001010101001100111111111001
1110110101111000010001001111010100011110011100110001010111010001
0000101100010110011100111101110111111010100001110010000011000011
0110100110111101010010111111000111110101001110010100101100101100
1100011111000101100011101110110010000011011110000001100001101101
1110001110000001100101100110000101011011001110001011111001100001
0000110100001100000110110101101011001100000011000000100111000100
0101001010011000001001000111111100001101100011110100011000010110
0110101111001011000000011001101110111100111000111001010101101001
1011111101100001111111100111110111001000111001101001011110100011
0111100010110101100001011100011000001111100110111010011101111100
1111000100010100101110101110101000100111101000010111000110001010
1110101001110011000110110110010110000101001001011000000010000000
0111100011111111101111100001100111010011100100101111110001001101
0100100001010111111100000000010010100010001001111110100000001101
0000111010100110111000001010010110000101111010100101000101001011
1111100010111010010100010110011111101011000010011011001110010111
0011000001011100011011000101001110101110110000101010010001001011
0001010110100010010011110100111110001110101001100111101000110101
1010110011110011101110110110001001001011100101001110011101011000
1111011010010100101110010110001110101011000101111101010111111100
1111110000010111100100101000110101100100010011111101001011111110
0100100100001111001110010000111111101000011000100000111111110110
1101001011010101111010111100101100100000011011000011111010011001
1100110100011010011011001100101001100011110111010101110001110100
0111101111011110011000100100110011001111101001011111110010000000
0011111011000001010010000001110110001001011100001100111100011000
1010011100100011100111101111011110110100101001001001000000011000
0000100110111101101011100110111110100110110100101111011010111101
0000010001111010011011110100110111100010000111000111101111111100
0001111000010100011000111111001001101111001010000000111101001110
0110011000101100100110110001100110111110001011100010101101000111
1110011001111011000110101111101101100101111000101011100000100100
0000000101010011111111101100010000001011110010000111010000001001
1000010000000011001000100100110110011000100110010000111110111000
0110101000101010101110010111011011010101111000110000001101011101
0110101111111011111110100101101110111000001011100110100000000000
1111001101010000100110010100011110000100011111000111010001110011
0110001010000001110011100110011001001001100001110000111111101010
1100011111000001000110100101100100100000111101010111101100110101
1110000011000100001111000011011101110110101011010111010111101010
1000011010001010100110001001111011110000000011110101110000011011
1100001011110011001101111110111000010011101100011001100110011100
1111101010011110011100010111011010100100011110011111000100001100
1010010110100111010110011010101001000000000001001001101011100010
1101011100010001110100111111011010110111100101000100010001110100
0010000110110011101111111100000111000101101011001110111100011110
1000010101010010110110110000010011101011110010101010000011110100
1001000010010001011001000001100011011111001010110011101111000100
1111001111111001101100101100111111101111101010111111110101000001
0001010110000010101000010000110100010111111001001100110000100101
1101110100011100110000110001010110000011111010100011110010110010
1101001010010001001111001011011000001000110001101010010011001110
1000011000101111000000010011100011111100101011111001100111110100
1110001010001110100110110011111000110011100111110000100001010100
0110100110010110111101110111001011111110100100110001111101011000
0010001110010111001000101100101001111101011010010000100000101001
1101100101000000000100110101111000100010100110011101000001110101
0001001010010001000101100100010100111010111001101101011001011010
0000001001101000001110101100001000100011001100010000010010000111
1010100110011110111000110100010011100111101111001110111101100101
0011110101110000011101011011000100001111111101000100101011010010
1000000101110111001011010000000010011111010000111111001011000011
0111100110001101111101010100110010001101100000010011000010001011
0100111100010001010110101111101110000101011100000100011000101110
1010010000000110111010001111001111110101111100011111000101101110
1011000000001110110101111001000101111001000100011001111001010000
0000010101110011001011110000101101100111001100101100010011110110
1101100011001110100110010111001001000111111000111011101001011110
1010010101000000011010011000110001100000111101110110000001110110
1010111010001101010101111011110101101011111100110011000101101010
1100001011110010000110110001101111101111011010100100100110010101
1111101001111111110111110011110000100001110011110000001011010101
0000110000111001111010110000001011001011111100110010000101001010
1011110111011110111011011001000111100011111011100111010100010110
1100001011101101100111100000001100000111111010000010101100011110
0011100110011000010001100011001101001010010101111010010001010100
0010010100001000011100101011100000000000111011100110100011010110
0000101001010011110010111100000000110000010001011110011100110101
1000000000000010101101011010001110011100110101000001011010100100
0010100010010011100001110000001010001100101011100100000010010100
0110100100011100010100110100010100000000100101010000001011110110
1101001101010010111001000001000010110110001100001101001101111100
1001101111010010000010011001111001001010100000111110101101111000
1001110100110001010100000010000010101010010110001001110001101010
1000111111111000001000100100101010001000110111111111001101100100
0101100001100000011101101001100010001101101001100000111101010100
1011100100101011010000011110000100001000100010011111011101010110
1101110110101101111000001001110000011100111010001110010100101101
1010000111111101110010011011110001101111010101000001000010111101
0010111110011111100010101010110001001000100111111111000111101001
1101010111011111110111110001111101110110111000010101010100110001
0011011100001011011000110001111100010111100111100101001110000001
0110001001110001001010111101000111110101110000001110001000100011
1011001111101100011010110111100001101111101001001010000010100110
0001100111001110011000100001110111101101111010100101110001110000
1010000100000101010110001101000011110100001110100000110010110111
1111001101000100010111011110011001111111011000010111100101011111
1111101011011010111011000010110101000011101000100110010101000010
0011001101000101100001100100000001101011111100000010001101101001
0010000001100101111011011001010100100001001010101010011001100101
0111110000111001011100110100010111011001011010100010100100001001
1111000110111100010001011100110001101011101100110011101100110001
1001001000011111111000001101011010100100010110101000100100010010
1010110110000111110101100001011111010011100101011101110110010001
1110010011010100010011010000100011110111101110010000110100101101
0000110010101111010100010000110010010011101000110011010111000000
0100100100101110000101010101100101111101110000111101011110010110
1001101100101111000011110110111101110010010001010010010000111011
1111011000111101100111110000110011111111011111001110111010000011
1100001011011010101000001001110000000000010001111011101110101000
0001011011001111110100001101011010011101111100101010011010101010
0111110000001110101100010101101110000010110100111010111101100111
1110100000010100101000010101001111110111011001010011010110000111
1100011100010110011110000110101000101010101000000001011011100110
1010101111111010000101000011110101001001011110010010011001111000
0100001011000110011101010100010100000100100101100011010001111010
1001000110111111110011110101111111111101001001011111000100001110
0111000010111000101010110110100110110011001110010101100100010101
1100100011110111000001101111100000100001011111111111101000010000
0101010101110010101010000010001111101000010000111001101100011001
1111101001011000000101101100110110110010001010001111011011100100
1011101100100101010000110001001110010000001101001011010100000000
1000101001000101000111010001100110100101011001000010000010000000
0001101001110111110111000101110011111100111101111111000110100100
1011100001110001000110011101110100001100010010110001110001110011
0011101111011101010111100000000010010100000101101111000111100001
0110110110000100101101100011100111110010001011101010100000001111
1011001011000001100010010001010000001010001011010000110001111000
0011100110101101001110111111110110101111111111001101100110001111
1100111000101001100011101101101000101100111000000100010011111111
1011100101101011010011101001110011110101000101100001100100001011
0100011100110001110001011110010100110111001111101001000000000101
1011010101100001000110010100111000010000100100101110010011111110
0110000001100000000000001110110111110110011000001101110001010100
1101001111011110000001001010111011100101111011010001011010100000
0110100110111101100001100000000101101011001011111011001101001001
1100100010100111011000110110001001100001010010000110001001101100
